dry:base	package	dry	WIP
dry:base/simd	package	dry	WIP
dry:bits	package	dry.bits	TODO
dry:code	package	dry.code	N/A
dry:crypto	package	dry.crypto	TODO
dry:crypto/hash	package	dry.crypto.hash	TODO
dry:data	package	dry.data	TODO
dry:ffi	package	dry.ffi	N/A
dry:geo	package	dry.geo	TODO
dry:io	package	dry.io	TODO
dry:lang	package	dry.lang	TODO
dry:logic	package	dry.logic	TODO
dry:math	package	dry.math	WIP
dry:math	class	dry.Math	WIP
dry:math/blas	package	dry.math.blas	WIP
dry:math/blas	class	dry.math.BLAS	WIP
dry:media	package	dry.media	TODO
dry:meta	package	dry.meta	WIP
dry:net	package	dry.net	TODO
dry:qty	package	dry.qty	TODO
dry:std	package	dry.std	TODO
dry:sys	package	dry.sys	TODO
dry:sys/linux	package	dry.sys.linux	N/A
dry:sys/posix	package	dry.sys.posix	TODO
dry:text	package	dry.text	WIP
dry:text/ascii	class	dry.text.ASCII	WIP
dry:text/printf	class	dry.text.Printf	WIP
dry:text/utf8	class	dry.text.UTF8	WIP
dry:time	package	dry.time	TODO
dry:util	package	dry.util	TODO
